==========
##==##==##
==##==##==
=#=#=#=#=#
#=#=#=#=#=
==##==##==
##==##==##
==========