 ===============
=   ===   ===   =
=    =     =    =
=       #       =
=       #       =
=  =         =  =
=   =========   =
 ===============