#===============#
=   ===   ===   =
=    =     =    =
=       #       =
=       #       =
=  =         =  =
=   =========   =
#===============#